####################
#1....B......B.....#
#.#.#.#.#.#.#.#.#.##
#..B....B....B.....#
#.#.#.#.#.#.#.#.#.##
#....B......B......#
#.#.#.#.#.#.#.#.#.##
#..B....B....B.....#
#.#.#.#.#.#.#.#.#.##
#....B......B......#
#.#.#.#.#.#.#.#.#.##
#..B....B....B.....#
#.#.#.#.#.#.#.#.#.##
#.....B......B....2#
####################
