####################
#1.................#
#..................#
#....###....###....#
#..................#
#..SSS......SSS....#
#..SSS......SSS....#
#.......####.......#
#..................#
#.##............##.#
#..................#
#....###....###....#
#..................#
#.................2#
####################
