####################
#1.................#
#.####.####.####...#
#..MMM......MMM....#
#..MMM......MMM....#
#..................#
#.####.####.####...#
#..................#
#.####.####.####...#
#..MMM......MMM....#
#..MMM......MMM....#
#..................#
#.####.####.####...#
#.................2#
####################
